NO maps/subject/textures/North.png
SO maps/subject/textures/South.png
WE maps/subject/textures/Westh.png
EA maps/subject/textures/Easth.png
F        220,100,0
C                       225,30,0


1111111111111
1000000000001
1000000000001
1000000000001
1000000000001
1000000000001
1011000000001
1001000000001
1001000000001
10010N0000001
1001000000001
1001000000001
1001000000001
1001000000001
1111111111111