NO maps/subject/textures/North.png
C        0,30,42
SO maps/subject/textures/South.png

F        0,42,30

WE maps/subject/textures/Westh.png


EA maps/subject/textures/Easth.png

        1111111  1111111111111111111
        1000011  1110110000000000001
        1011011  1111110000000000001
        1001011  111000000N000000001
 111111111011011  1111110000000000001
 1000000000110111  111110111111111111
 111111111111111  1111111111111111111
          111      1       1
     1111111111111111   111111111111111111111
     11110111111111111      100000010001
     11110111111111011111    1111110011
     11000000110101011100111       10001
     10000000000000001100000111111  1111
     10000000000000001101010010001
     110000011101010111110111100011111
     11110111 1110101 101111010001
     11111111 1111111 111111111111
