NO maps/subject/textures/North.png
SO maps/subject/textures/South.png
WE maps/subject/textures/Westh.png
EA maps/subject/textures/Easth.png
F        0,42,30
C        0,30,42





111     1111111111111111111111111
101     1000000000110000000000001
111     1011000001110000000000001
        100100000222000N000000001
111111111011000001110000000000001
100000000011000001110111111111111
111111111111111111111111111111111
                  
111111111111111111111111111111111
11110111111111011100000010001
11110111111111011101010010001
11000000110101011100000010001
10000000000000001100000010001
10000000000000001101010010001
110000011101010111110111100011111
11110111 1110101 101111010001
11111111 1111111 111111111111
