NO maps/subject/textures/North.png
C        0,30,42
SO maps/subject/textures/South.png

F        0,42,30

WE maps/subject/textures/Westh.png


EA maps/subject/textures/Easth.png

        1111111111111111111111111
        1000000000110000000000001
        1011000001110000000000001
        100100000000000N000000001
111111111011000001110000000000001
100000000011000001110111111111111
111111111111000011111111111111111
          11000011    
111111111111000011111111111111111
11110111111110001100000010001
11110111111111011101010010001
11000000110101011100000010001
10000000000000001100000010001
10000000000000001101010010001
110000011101010111110111100011111
11110111 1110101 101111010001
11111111 1111111 111111111111
