NO maps/subject/textures/North.png
SO maps/subject/textures/South.png
WE maps/subject/textures/Westh.png
EA maps/subject/textures/Easth.png
F        0,42,30
C        0,30,42





        1111111111111111111111111
        1000000000110011001000111
        1011000001110000000000011
        1001000000000000000000001
111111111011000000000000000000111
111111111011000000000000000000011
111111111011000000000000000000001
111111111000000000000000000000001
100000000000000001110101010110101
100000000000000001110111111111111
100000000000000000000111111111111
100000000000000000000111111111111
100000000011000001110111111111111
111111111111110111111111111111111
             101  
1111111111111101111111111111111111111111111111111
111101111111110111000000000000000000000010001
111101111111110111010000000000000000010010001
110000011101010011000000000000000000000010001
100000000000000000000000000000000000000010001
100000000000000000000000000000000000000000001
10000000N000000000000000000000000000000010001
100000000000000000000000000000011000000010001
100000000000000000000000000000011000000000001
100000000000001100000000000000000000000010001
100000000000001100000000000000000000000010001
100000000000000000000000000000000000000010001
100000000000000000000000000000000000000000001
100001000000000000000000000000000000000000001
100000000000000000000000000000010000000010001
100000000000000011010000000000000000010010001
1100000111010101111100000000000000000111100011111
11110111 1110101 1011111111111111111111010001
11111111 1111111 1111111111111111111111111111
