NO maps/subject/textures/North.png
SO maps/subject/textures/South.png
WE maps/subject/textures/Westh.png
EA maps/subject/textures/Easth.png
F        220,100,0
C                       225,30,0


1111111
1000001
1010001
1001001
10N0101
1000001
1111111