NO maps/smol/textures/North.png
SO maps/smol/textures/South.png
WE maps/smol/textures/Westh.png
EA maps/smol/textures/Easth.png
C        3,12,96
F        72,36,0

1111111111111
1000000000001
1000000000001
1000000000001
1000012100001
1000000000001
1000000000001
101000N000001
1030000000001
1010000000001
1000000000001
1000000000001
1111111111111
