NO maps/subject/textures/North.png
SO maps/subject/textures/South.png
WE maps/subject/textures/Westh.png
EA maps/subject/textures/Easth.png
F        220,100,0
C                       225,30,0


11111
10001
10N01
10001
11111