NO maps/smol/textures/North.png
SO maps/smol/textures/South.png
WE maps/smol/textures/Westh.png
EA maps/smol/textures/Easth.png
C        3,12,96
F        72,36,0


1111111 1111111111
1000001 1000000001
1010001 1000010001
1001001 1000000001
10N0101 1000010001
1000001 1000000001
1111111 1111111111