NO images/BUGS/beetle.png
SO images/BUGS/caterpillar.png
WE images/BUGS/spider.png
EA images/BUGS/liveloula.png
DO images/BUGS/liveloula.png
F        120,100,150
C                       90,90,90

1111111111111111111111111111111111111111111111
1E011111000000000111111111111100000000000011111
110000000001111111111111111111100111111111110111
111001111101111111101111  11111100111111111101111
111100001101111111101111  111111100111100000011111
111110000100001111101111111111111100111000000111111
111111000111101111101111111111111110011100000111111
111111100001101111101111110000000000001111000111111
111111001111100000000011111111111111001111110000011
111110011111111111111011111111111111001111110111011
1111001111    1111111011110011111110011111110111011
1110011111    1111111011110011111100111101110111011
110011111111111111111011111111111000000000000001111
100000000000000000000011111111110011111011110111111
 1111111111111111111101111111111001111101111011111
  11111111      111110000000000001111110000000011
   111111111111111111111111111111111111111111111
