NO images/MUPPETS/animal.png
SO images/MUPPETS/Easth_elmo.png
WE images/MUPPETS/gonzo.png
EA images/MUPPETS/kermit_sunflowers.png
DO images/MUPPETS/meeeep.png
F        120,100,150
C                       90,90,90

1111111111111111111111111111111111111111111111
1E011111000000000000000000000000000000000011111
110000000001111111111111111111100111111111110111
1110011111011 1 11101111  11111100111111111101111
111100001101111111101111  111110100111100000011111
 1 11000010000000000111111111110110011100000011  11
 1  110001111011111011  11111110111001110000011  11
 1  111000011011111011  110000000000001111000111111
 1  11001111100000000011111111111111001111110000011
 1 110011111111111111011111111100000000111110011011
 111001111    1111111011110011111110011111110111011
 110011111    1111111011110011111100111101110111011
110011111111111111111011100001111000000000000001111
100000000000000000000011100001110011111011110111111
11111111111111111111101110000111001111101111011111
  11111111      111110000000000001111110000000011
   111111111111111111111111111111111111111111111
