NO images/DEBUG/North.png
SO images/DEBUG/South.png
WE images/DEBUG/Westh.png
EA images/DEBUG/Easth.png
DO images/rickgif.gif
C        3,12,96
F        72,36,0

1111111111111
1000000000001
1000000000001
100000N000001
1000012100001
1000000000001
1000000000001
1010000000001
1030000000001
1010000000001
1000000000001
1000000000001
 11111111111 
