NO images/BUGS/beetle.png
C        0,30,42
SO images/BUGS/liveloula.png

F        0,42,30

WE images/BUGS/spider.png

DO images/shrok.gif
EA images/BUGS/caterpillar.png

       1111111  1111111111111111111
       1000011  1110121312100000001
       1011011  1111100000000011001
       1001011  11100000W0000002001
111111111011011  1110000000000010001
11   11000110111  100000112121111111
1111 11111011111 1001111111111111111
         101     10111    1
          11      1
       1  1       11      
    11111101111111011111111111111111111111111
    11110100011111011      100000010001
    11110100011111011111    1111110011
    11000000110101011100111       10001
    10000000000000001100000111111  1111
    10000000000000001101010010001
    110000011101010111110111100011111
    11110111 1110101 101111010001
    11111111 1111111 111111111111
