NO images/rickgif.gif
C        0,30,42
SO images/rickgif.gif

F        0,42,30

WE images/rickgif.gif

DO images/rickgif.gif
EA images/rickgif.gif

        1111111  1111111111111111111
        1000011  1110121312100000001
        1011011  1111100000000001001
        1001011  111000000N000002001
 111111111011011  1110000000000010001
 1000000000110111  100000112121111111
 111111111101111  1001111111111111111
          101    110111    1
     111111011111110111 111111111111111111111
     11110100011111011      100000010001
     11110100011111011111    1111110011
     11000000110101011100111       10001
     10000000000000001100000111111  1111
     10000000000000001101010010001
     110000011101010111110111100011111
     11110111 1110101 101111010001
     11111111 1111111 111111111111
